COMMENT This is how it will display atm.
WIDTH 2
LEVELNAME:Level Fiveish i reckon
BREAK
################
#--------------#
#--------------#
#----#####-----#
#---###--------#
#--##----------#
#--##----------#
#--##----###---#
#--##-----##---#
#--##-----##---#
#---###---##---#
#-----#####----#
#--------------#
#--------------#
#--------------#
################
BREAK
################
#--------------#
#--------------#
#----######----#
#---##----##---#
#--##------##--#
#--##------##--#
#--##------##--#
#--##########--#
#--##------##--#
#--##------##--#
#--##------##--#
#--------------#
#--------------#
#--------------#
################
BREAK
################
#--------------#
#--------------#
#--------------#
#--###----###--#
#---###--###---#
#----######----#
#-----####-----#
#------##------#
#------##------#
#------##------#
#------##------#
#------##------#
#--------------#
#--------------#
################
BREAK
################
#--------------#
#--------------#
#--------------#
#--------------#
#--------------#
#--------------#
#--------------#
#--##-----##---#
#--##-----##---#
#---###---##---#
#-----#####----#
#--------------#
#--------------#
#--------------#
################
BREAK
################
#--------------#
#--------------#
#--------------#
#--------------#
#--##------##--#
#--##------##--#
#--##------##--#
#--##########--#
#--##------##--#
#--##------##--#
#--##------##--#
#--------------#
#--------------#
#--------------#
################
BREAK
################
#--------------#
#--------------#
#--------------#
#--------------#
#--------------#
#--------------#
#------##------#
#------##------#
#------##------#
#------##------#
#------##------#
#--------------#
#--------------#
#--------------#
################
BREAK
################
#--------------#
#--------------#
#--------------#
#--------------#
#--##----------#
#--##----------#
#--##----------#
#--##----------#
#--##----------#
#--------------#
#--------------#
#--------------#
#--------------#
#--------------#
################
BREAK
################
#--------------#
#--------------#
#--------------#
#----######----#
#--------------#
#--------------#
#--------------#
#--##########--#
#--##------##--#
#--##------##--#
#--##------##--#
#--------------#
#--------------#
#--------------#
################
BREAK