COMMENT D for endlevel, # for block.
LEVELNAME:Level Template
WIDTH 2
BREAK
%$$$$$$$$$$$$$$@
%--------------@
%--------------@
%--------------@
%--------------@
%--------------@
%--------------@
%--------------@
%--------------@
%--------------@
%--------------@
%--------------@
%--------------@
%--------------@
%--------------@
%&&&&&&&&&&&&&&@
BREAK
%$$$$$$$$$$$$$$@
%--------------@
%--------------@
%--------------@
%--------------@
%--------------@
%--------------@
%--------------@
%--------------@
%--------------@
%--------------@
%--------------@
%--------------@
%--------------@
%--------------@
%&&&&&&&&&&&&&&@
BREAK
%$$$$$$$$$$$$$$@
%--------------@
%--------------@
%--------------@
%--------------@
%--------------@
%--------------@
%--------------@
%--------------@
%--------------@
%--------------@
%--------------@
%--------------@
%--------------@
%--------------@
%&&&&&&&&&&&&&&@
BREAK
